132
8
31	31	31	31	31	31	31	0	0	0	0	0	0	0	0	0	0	0	0	0	0	0	0	0	0	0	0	0	0	0	0	0	0	0	0	0	0	0	0	0	0	0	0	0	0	0	0	0	0	0	0	0	0	0	0	0	0	0	0	0	0	0	0	0	0	0	0	0	0	0	0	0	0	0	0	0	0	0	0	0	0	0	0	0	0	0	0	0	0	0	0	0	0	0	0	0	0	0	0	0	0	0	0	0	0	0	0	0	0	0	0	0	0	0	0	0	0	0	0	0	0	0	0	0	0	0	0	0	0	0	0	0
31	31	31	0	0	0	0	0	0	0	0	0	0	0	0	0	0	0	0	0	0	0	0	0	0	0	0	0	0	0	0	0	0	0	0	0	0	0	0	0	0	0	0	0	0	0	0	0	0	0	0	0	0	0	0	0	0	0	0	0	0	0	0	0	0	0	0	0	0	0	0	0	0	0	0	0	0	0	0	0	0	0	0	0	0	0	0	0	0	0	0	0	0	0	0	0	0	0	0	0	0	0	0	0	0	0	0	0	0	0	0	0	0	0	0	0	0	0	0	0	0	0	0	0	0	0	0	0	0	0	0	0
31	31	31	0	0	0	30	0	0	0	0	0	0	0	0	0	0	30	30	30	0	30	30	0	0	30	30	0	0	30	0	0	0	0	0	0	0	0	0	0	0	0	0	0	0	0	0	0	0	0	0	0	0	0	0	0	0	0	0	0	0	0	0	0	0	0	0	0	0	30	30	30	0	0	0	0	0	0	0	0	0	0	0	0	0	0	0	0	0	0	0	0	0	0	0	0	0	30	0	0	0	0	0	0	0	0	0	0	0	0	0	0	30	30	0	0	0	0	0	0	0	0	0	0	0	0	0	0	0	0	0	0
31	31	31	0	0	0	31	0	0	0	0	0	0	0	0	0	0	31	0	31	0	31	0	30	0	31	0	30	0	31	0	0	0	0	0	0	0	0	0	0	0	0	0	0	0	0	0	30	0	0	0	0	0	0	0	0	0	30	30	30	30	0	0	0	0	0	0	0	0	31	31	31	30	30	0	0	0	0	0	0	0	0	0	30	0	0	30	0	0	0	0	0	0	0	0	0	30	31	30	30	0	0	30	30	30	0	0	30	30	30	0	0	31	0	30	0	0	0	0	0	0	0	0	0	0	0	0	0	0	0	0	0
31	31	31	30	30	30	31	0	0	0	0	0	0	0	30	0	0	31	30	31	0	31	0	31	0	31	0	31	0	31	0	0	0	0	0	0	0	0	0	0	0	0	0	0	0	0	0	31	0	0	0	0	0	0	0	0	0	31	31	31	31	30	30	30	30	30	0	0	30	31	31	31	31	31	0	30	0	30	0	0	0	30	30	31	0	0	31	30	0	30	30	0	0	0	0	0	31	31	31	31	0	0	31	0	31	0	0	31	0	31	0	0	31	30	0	0	30	30	30	0	0	0	0	0	0	0	0	0	0	0	0	0
31	31	31	31	31	31	31	0	0	0	0	0	0	0	31	0	0	31	0	31	0	31	0	31	0	31	0	31	0	31	0	0	0	0	0	30	30	0	0	0	0	30	30	0	0	30	30	31	0	30	30	30	30	30	30	30	30	31	31	31	31	31	31	31	31	31	30	30	31	31	31	31	31	31	30	31	30	31	30	0	0	31	31	31	0	30	31	31	0	31	31	0	0	0	0	30	31	31	31	31	0	0	31	0	31	0	0	31	0	31	0	0	31	0	0	0	31	31	31	30	30	30	30	30	30	30	30	30	30	30	30	30
31	31	31	31	31	31	31	30	30	30	30	30	30	30	31	0	0	31	0	31	0	31	0	31	0	31	0	31	0	31	0	0	0	0	0	0	0	0	0	0	0	0	0	0	0	31	31	31	0	31	31	31	31	31	31	31	31	31	31	31	31	31	31	31	31	31	31	31	31	31	31	31	31	31	31	31	31	31	31	0	0	31	31	31	0	31	31	31	0	31	31	0	0	0	0	31	31	31	31	31	0	0	31	0	31	0	0	31	0	31	0	0	31	0	0	0	31	31	31	31	31	31	31	31	31	31	31	31	31	31	31	31
31	31	31	31	31	31	31	31	31	31	31	31	31	31	31	0	0	31	0	31	0	31	30	31	0	31	30	31	0	31	0	0	0	0	0	0	0	0	0	0	0	0	0	0	0	31	31	31	0	31	31	31	31	31	31	31	31	31	31	31	31	31	31	31	31	31	31	31	31	31	31	31	31	31	31	31	31	31	31	0	0	31	31	31	0	31	31	31	0	31	31	0	0	0	0	31	31	31	31	31	0	0	31	30	31	0	0	31	30	31	0	0	31	0	0	0	31	31	31	31	31	31	31	31	31	31	31	31	31	31	31	31